001:
honest: 诚实的, 正直的;
honesty: 诚实, 正直;
usually: 通常地, 经常地;
usual: 通常的, 经常的;
harmful: 有害的, 造成损害的;
harm: 伤害, 损害;
lying: 说谎的, 躺着的, 说谎, 横卧;
guilty: 有罪的, 内疚的;
guilt: 犯罪, 过失;
trouble: 麻烦, 使麻烦;
hurt: 痛苦, 危害, 使受伤;
ruin: 废墟, 灭亡, 使破产;
reputation: 名声, 名誉, 声望;
worst: 最差的, 最坏的;
cause: 原因, 事业, 目标, 引起, 使遭受;
conscience: 道德心, 良心;
bother: 麻烦, 烦恼, 使...不安, 烦扰;
worth: 值...的, 价值, 财产;
occurs: 发生, 出现(三单);
learn: 学习, 得知, 认识到;
angry: 生气的, 愤怒的;
gain: 利润, 增加, 获得, 赚到;
liar: 说谎的人;
rid: 使摆脱, 使去年;
shame: 羞耻, 羞愧, 使丢脸;
policy: 政策, 方针;
introduce: 介绍, 引进, 提出;
extent: 程度, 范围, 长度;
according: 相符的, 一致的, 根据, 按照;

002:
vacation: 假期, 休假, 度假;
arrangement: 安排, 布置, 整理;
remain: 保持, 留下, 剩余, 遗迹, 剩余物;
campus: 校园, 大学, 大学生活;
during: 在...时候, 在...期间;
winter: 冬季, 年岁, 过冬, 冬天的;
dean: 院长, 系主任, 教务长;
responsibility: 责任, 职责, 义务;
explain: 说明, 解释;
fill out: 填写;
forms: 表格, 表单;
reduce: 减少, 降低;
heating: 加热, 供暖, 加热的;
cost: 花费, 成本;
hall: 门厅, 会堂, 食堂, 学生宿舍;
butler: 男管家;
dormitory: 宿舍, 学生宿舍;
dorm: 宿舍;
reopen: 重开, 使再开;
assign: 分配, 指派;
belonging: 行礼;
temporary: 暂时的, 临时的;
accommodations: 住房, 住宿;
possible: 可能的, 合理的, 可能性;
once: 一旦, 一次, 曾经;
facility: 设施, 设备;
gymnasium: 体育馆, 健身房;
store: 商店, 仓库;
dining-hall: 餐厅, 饭厅;
library: 图书馆, 文库;
though: 可是, 虽然, 不过, 尽管;
schedule: 安排, 计划, 时间表;
college: 大学, 学院;
maintain: 维持, 继续, 维修, 供养;
regular: 定期的, 有规律的, 常客, 定期地;
since: 因为, 由于, 既然, 自...以后, 自...以来;
imagine: 想象, 猜想, 想起来;
finish: 完成, 结束, 完美;
finish up: 完成, 结束, 用光;
academic: 学术的, 理论的, 大学生;
project: 设计, 计划,, 工程, 事业;
hesitate: 踌躇, 犹豫, 有疑虑, 不愿;
contact: 联系, 使接触;
winter break: 寒假, 圣诞节假日;
period: 周期, 期间;
normally: 正常地, 通常地, 一般地;

003:
Wherever: 无论什么地方, 究竟在哪里, 无论在哪里;
referred: 参考, 查阅, 归类, 谈及, 援引的;
rush hour: 交通拥挤的时间, 上下班高峰时间;
rush: 冲进, 匆促, 使冲, 奔, 闯;
streams: 数据流, 流淌, 使...飘扬;
important: 重要的, 重大的, 有权力的;
popular: 流行的, 受欢迎的;
transportation: 运输;
compare: 比较, 对照;
cheap: 便宜的, 小气的, 不值钱的, 便宜地;
convenient: 方便的, 实用的, 适当的;
parking-lot: 停车厂;
crowd: 拥挤, 挤满, 将...塞进, 群众, 大众;
garage: 车库, 飞机库, 汽车修理厂, 把...送入车库;
fuel: 燃料, 得到燃料, 加燃料;
pollution-free: 无污染的;
pollution: 污染, 污染物;
cycling: n. 骑单车;
however: 无论如何, 然而, 可是;
consequently: 因此, 结果, 所以;
obey: 服从, 听从; 按...行动;
traffic: 交通, 运输, 交易, 用...交换;
regulation: 管理, 规则, 平常的;
regular: 定期的, 有规律的, 普通的, 常客;
cause: 原因, 引起;
accident: 事故, 意外;
associate: 交往, 关联, 使联合;
experimental: 实验的, 试验性的;

004:
visit: 看望, 访问;
and so on: 等等, 诸如此类;
boiling: 沸腾的, 激昂的, 沸腾;
boil: 煮沸, 沸腾, 使...激动;
afford: 给予, 提供, 买的起;
repair: 修理, 修复, 纠正;
handy: 灵巧, 灵活;
convenient: 方便的, 实用的, 适当的;
contrary: 对立的, 相反的, 相反, 反面;
health: 健康, 卫生, 兴旺;
In addition: 另外, 此外;
uses: n. 使用, 用途;
perhaps: 或许, 也许, 可能, 假定;

005:
Friendship: 友谊, 友爱, 友善;
develop: 发展, 成长, 开发, 使成长;
childhood: 童年时期, 儿童时代;
progress: 进步, 发展, 前进;
though: 虽然, 尽管, 但是;
through: 通过, 穿过, 彻底, 从头至尾;
through: 直达的, 完结的;
influence: 影响, 感化, 改变, 势力;
development: n. 发展, 开发, 发育;
maturity: 成熟, 到期, 完备;
responsibility: 责任, 职责, 义务;
sense: 感觉, 观念, 理智, 检测;
familiar: 熟悉的, 常见的, 亲近的, 常客, 密友;
expression: 表现, 表达, 表情, 说法;
common: 共同的, 普通的, 一般的, 平民, 普通;
interests: (复数) 利益, 兴趣, 爱好, 使...感兴趣;
athletic: 运动的;
superficial: 表面的, 肤浅的, 外表的;
count: 计算, 认为;
whether: 是否, 不论, 两者中的哪个;
eager: 渴望的, 热切的, 热心的;
build up: 增进, 加强;
confidence: 信心, 信任, 秘密;


