Recently, there is a heated debate over which one is better, A or B.
Recently, there is a heated debate over whether A is good or not.
Some people hold the view that A is good, while others argue that B is better.
Some people hold the view that A is good, while others argue that A is harmful.
For my part, I am strongly in favor of the former one.
For my part, I am strongly in favor of the latter one.
The reasons are as follows.
First and foremost
For instance
What is more,
Take another case for example
Last but not least,

Dear Jack,
How have you been recently?
I am writing to invite you to take part in my birthday party.
My birthday party will be held on October 22th, 2018.
The arrangements are as follows.
First and foremost
For instance
What is more,
Take another case for example
Last but not least,
It would be much appreciated if you can attend it.
I am sure that you will enjoy the party.
I am looking forward to your early reply.
I wish you all the best.
Your sincerely.

All in all,
based on the reasons mentioned above.
there is no denying that... ...
A matters much more than B in my heart.
Therefore
It is of great significance for us to ... ...

First and foremost
For instance
What is more,
Take another case for example
Last but not least,
For example
As the famous saying goes,

Error: 错误;
Use: 使用;
Eventually: 最后;
Graceful: 优雅的;
Neccessary: 必要的;
Situations: 场景;
Firstly: 首先;
Wrong: 错误的;
Instead: 相反;
Success: 成功;
Greatest: 最好的;
Look: 看;
Seem: 看起来似乎;
Give: 给;
Place: 地方;
Talk: 说;
Statues: 雕像;
Tourist: 游客;
Extraordinary: 优秀的;
Lines: 线, 排;
Get: 得到;
Rarely: 稀少;
Say: 说;
Usually: 通常;
Big: 大的;
Need: 需要;
What: 什么;
Before: 之前;
Reach: 达到;
Which: 哪个;
Conflict: 冲突;
Effectively: 有效地;
Way: 方式;
How: 如何;
Small: 小的;
Opportunity: 机会;
Changing: 持续改变的;
Reasons: 原因;
Popular: 受欢迎的, 流行的;
Found: 发现;
Anywhere: 任何地方;
Down: 往下;
Finding: 发现;
Level: 水平;
Different: 不同的;
Away: 远离;
Outdoor: 户外;
Sleep: 睡觉;
Probable: 很可能的;
Start: 开始;
Wrong: 错误的;
Actually: 实际上, 事实上;
Chance: 机会, 际遇;
Note: 笔记, 注意;
Direction: 方向, 指导, 趋势;
Special: 特别的, 专门的;
Analyze: 分解, 对...进行分析;
Finally: 最后;
Grow: 发展, 生长;
Pleasant: 令人愉快的, 舒适的;
Early: 早期的, 提早;
Faster: 更快的;
Involved: 涉及, 包含, 有关的;
Test: 测试;
Produce: 生产;
Neglect: 忽略, 疏忽;
Seldom: 很少;
Study: 研究, 学习;
Rate: 比率;
Taught: 教;
Current: 当前的, 现在的;
Really: 真正地;
Meeting: 会议;
Wise: 明智的, 博学的;
Poses: 姿势;
Courage: 勇气, 胆量;
Take: 拿, 取;
Always: 总是;
Careful: 仔细的, 小心的;
Uncomfortable: 不舒服的, 不安的;
Growth: 发展, 增长;
Set: 设置, 集合;
Mentally: 精神上, 心里上;
Changing: 改变, 转换;
Huge: 巨大的;
Increase: 增加, 提高;
Grow: 发展, 生长;
Places: 地点, 位置, 放置;
Small: 少的, 小的;
Lead: 领导, 带头;
Certain: 必然的, 某些;
Survival: 幸存;
Either: 或者;
Also: 也;
Danger: 危险;
Fame: 名声;
Famous: 著名的;
Able: 能够的;
Ability: 能力;
Term: 术语;
Terms: 术语的复数;
Demonstrate: 证明, 阐释;
Demonstrated: 阐释的过去分词;
Name: 命名;
Named: 命名的过去分词;
Extreme: 极端的;
Extremely: 极端地;
Find: 发现;
Finding: 发现(动名词);
Sit: 坐;
Sat: 坐的过去式;
Easy: 简单的;
Uneasy: 不简单的;
present: 出席的;
presence: 出现;
blame: 责备;
blamed: 被责备的;
Actual: 实际的;
Actually: 实际地;
Hear: 听到;
heard: 听到的过去式;
Nature: 自然;
Natural: 自然的;
Consider: 考虑;
Considered: 考虑的过去分词;
Advantage: 优势;
Advantages: 优势的复数;
Correct: 正确的;
Incorrect: 不正确的;
Go: 去;
Went: go的过去分词;
Spirit: 精神;
Spirits: 精神的复数;
Wise:  聪明的;
Wisely: 聪明地;
Treat: 对待;
Treatment: 对待的名词;
Real: 真正的;
Really: 真正地;
Pleasant: 令人愉快的;
Unpleasant: 不愉快的;
Lose: 失去, 失败;
Loss: 损失;
Ask: 询问;
Asked: 询问的过去分词;
Surprise: 惊讶, 惊喜;
Surprising: 令人惊喜的;
Annoy: 使恼怒;
Annoying: 令人恼怒的;
Respond: 回应;
Responded: 回应的过去式;
Decide: 决定;
Decision: 决策, 决定;
Listen: 听;
Listener: 聆听者;
Wait: 等待;
Waiter: 服务生;
Have: 拥有;
Had: have的过去式;
Work: 工作;
Working: 工作的现在分词;
Difference: 差异;
Diffrent: 不同的;
Real: 真正的;
 Really: 真正地;
Amaze: 使惊讶;
Amazing: 令人惊讶的;
Help: 帮助;
Colleague: 同事;
Thank: 谢谢;
Thankful: 感激的;
Grateful: 感激的;
Gratefulness: 感激;
Happy: 快乐的;
Happier: 更快乐的;
Quick: 迅速的;
Quickly: 迅速地;
Move: 移动, 迁移;
Moved: 移动, 感动的过去式;
Learner: 学习者;
Learners: 学习者的复数;
Add: 加, 增加;
Addition: 添加, 加法;
Able: 能, 能干的;
Enable: 使能够;
Few: 很少的;
Fewer: 较少的;
Culture: 文明, 文化;
Cultures: 文化, 文明的复数;
Machine: 机器;
Machines: 机器的复数;
Give: 给, 授予;
Given: 增予的过去分词;
Necessary: 必需的;
Unnecessary: 不必要的;
Real: 现实, 实际的;
Really: 真正地, 确实地;
Employment: 雇佣;
Unemployment: 失业;
Include: 包含, 包括;
Including: 包含, 包括;
Dream: 梦想, 愿望;
Dreaming: 做梦;
Care: 照顾, 关心;
Careful: 仔细的;
Plan: 计划, 打算;
Planned: 计划的过去分词;
Final: 决赛, 期末考试;
Finally: 最后, 终于;
Thought: 思考, 认为;
Thoughts: 思考, 认为的复数;
Education: 教育;
Educational:  具有教育意义的;
Worry: 担心;
 Worried: 感到担心的;
Do: 做, 干;
Doing: 做, 干;
Long: 长;
Longer: 更长的;
Interpret: 解释;
Misinterpret: 误解;
Real: 真正的;
Really: 真正地;
Bear: 生育, 忍受;
Born: 生育的过去分词;
Clear: 清楚的;
Unclear: 不清楚的;
Result: 结果;
Resulted: 结果, 致使;
behave: 表现;
behavior: 行为, 举止;
Grow: 发展, 生长;
Growth: 增长, 发展的名词;
Do: 做;
done: 已做完, 已完成;
Manufacture: 制造;
Manufacturing: 制作的现在分词;
Hide: 躲藏, 隐藏;
Hidden: 被隐藏的;
easy: 容易;
easily: 容易地;
tear: 眼泪;
tears: 眼泪的复数;
define: 定义;
defines: 定义的三单;
deep: 深的;
deepen: 加深;
 use: 使用;
used: 使用过的;
power: 力量;
powerful 强大的;
act: 行为, 表演, 执行;
action: 行动;
direct: 直接的;
directly : 直接地;
Communicate: 沟通;
communication: 沟通;
clear: 清楚;
unclear: 不清楚;
respond: 回应;
responds: 回应的三单;
behave: 表现, 行为;
behavior: 行为, 举止;
effective: 有效的;
effectively: 有效地;
do: 做;
done: 已完成的;
person: 个人;
personal: 私人的, 个人的;
hide: 躲藏, 隐藏;
hidden: 被隐藏的;

fall-fell-fallen 跌落,
Eat-ate-eaten 吃,
give-gave-given 给,
see-saw-seen 看,
put-put-put 放,
read-read-read 读,
bear-bore-born 生,
wear-wore-worn 穿,
begin-began-begun 开始,
drink-drank-drunk 喝,
ring-rang-rung 响,
sing-sang-sung 唱,
leave-left-left 离开,
feel-felt-felt 感觉,
keep-kept-kept 保持,
sleep-sleft-sleft 睡觉,
bring-brought-brought 带来,
buy-bought-bought 购买,
fight-fought-fought 打架,
catch-caught-caught 抓住,
teach-taught-taught 教,
build-built-built 建筑,
send-sent-sent 发送,
spend-spent-spent 花费,
meet-met-met 见面,
lead-led-led 领导,
have-had-had 有,
hear-heard-heard 听到,
hold-held-held 举办,
leave-left-left 离开,
lose-lost-lost 失败,
make-made-made 制作,
have-had-had 有,
hear-heard-heard 听,
sit-sat-sat 坐,
speak-spoke-spoken 说,
freeze-froze-frozen 结冰,
break-broke-broken 打破,
steal-stole-stolen 偷,
rise-rose-risen 升起,
choose-chose-chosen 选择,
drive-drove-driven 载,
ride-rode-ridden 骑,
wake-woke-waken 唤醒,
write-wrote-written 写,
lay-laid-laid 躺,
pay-paid-paid 付款,
say-said-said 说,
understand-understood-understood 理解,
stand-stood-stood 站立,
come-came-come 来,
become-became-become 成为,
shake-shook-shaken 摇摆,
take-took-taken 拿,
do-did-done 做,
go-went-gone 去,
is/am-was-been 是,

--------新增不规则动词-------------
are-were-been 是,
beat-beat-beaten 打,
bet-bet-bet 打赌,
blow-blew-blown 吹,
mean-meant-meant 意思是,
meet-met-met  遇见,碰到,
my-might 可以,
mistake-mistook-mistaken 犯错,
run-ran-run 跑,
sweep-swept-swept  打扫,
swim-swam-swum 游泳,
tell-told-told 告诉,
throw-threw-thrown 扔,
win-won-won 获胜,
dream-dreamt/dreamed-dreamt/dreamed 做梦,
feed-fed-fed 喂养,
find-found-found 找,
fly-flew-flown 飞,
forget-forgot-forgotten 忘记,
sell-sold-sold 卖,
set-set-set 安装,
shine-shone/shined-shone/shined 照耀,
show-showed-shown 显示,
shut-shut-shut 关,
sink-sank-sunk 下沉,
keep-kept-kept 保持,
know-knew-known 知道,
learn-learnt-learnt 学习,
lend-lent-lent 借给,
let-let-let 让,
lie-lay-lain 说谎,
smell-smelt-smelt 闻,嗅
spell-spelt-spelt 拼写,
spill-spilt-spilt 洒,
spit-spat-spat 吐痰,
spoil-spoilt-spoilt 糟蹋,
get-got-gotten/got 得到,
grow-grew-grown 成长, 种,
hang-hung-hung 吊, 悬挂,
hit-hit-hit 打,击,
hurt-hurt-hurt 伤害,
burn-burnt-burnt 燃烧,
can-could 能,
cost-cost-cost 花费,
cut-cut-cut 切,砍,

